########################################
#                                      #
#@  #                                  #
####################                   #
#                  #                   #
#                 S#                   #
#                  #                   #
#    ###############         ###########
#                            #         #
#                            #    C    #
#                            #         #
#                            #         #
#                            #         #
#                            #         #
#                                      #
########################################