########################################
#                  S                   #
#                                      #
#                                      #
###################D####################
#                                      #
#                                      #
#                                      #
#  ##############     ###############  #
#               #     #                #
#               #     #                #
#               #     #                #
#               #     #                #
#               #     #                #
#              C#  @  #K               #
########################################