########################################
#                  #                   #
#                  #  C                #
#                  #                   #
#             ###########              #
#                       #              #
#             #         #              #
#######  ######    @    ########  ######
#             #         #              #
#             ###########              #
#                  #                   #
#                  #                   #
#                                  S   #
#                  #                   #
#                  #                   #
########################################