########################################
#                 #  #                 #
#                S#  #                 #
#                 #  #                 #
#  ################  ###############   #
#                                      #
#                                      #
#    ##############  #########D#########
#    #            #  #                 #
#    #           K#  #                 #
#    #            #  #                 #
#    #          ###  ###               #
#               #      #               #
#               #      #               #
#               #  @   #      C        #
########################################