########################################
#                              #      @#
#                              #       #
#                                      #
#                              #       #
#     ##############D###################
#     #                                #
#     #                                #
#     #                              S #
#     #                                #
#     #                                #
#     #                                #
#     ##################################
#                                     K#
#                                      #
########################################