########################################
#     @       #                        #
#             #                        #
#             #                        #
#             #       #                #
#             #       #                #
#             #       #                #
#             #       #                #
#             #       #                #
#             #       ########  ########
#             #       #                #
#             #       #                #
#             #       #       S        #
#                     #                #
#                     #                #
########################################