########################################
#                 S                    #
# C                                  C #
#                                      #
#                                      #
################## #####################
#                                      #
#                                      #
#                                      #
#                                      #
#                 @                    #
#                                      #
#                                      #
#                                      #
#                 T                    #
########################################