                            ############
                            #    C     #
                            #          #
                            #          #
#############################          #
#                                      #
#@                                    S#
#                                      #
#                                      #
#############################          #
                            #          #
                            #          #
                            #    T     #
                            ############
                                        
                                        