########################################
#    S      #      @      #      C     #
#           #             #            #
#           #             #            #
#           ####### #######            #
#               #     #                #
#               #     #                #
#               #     #                #
#               #     #                #
#               #     #                #
#               #     #                #
#               #     #                #
#######  ########     #########  #######
#                                      #
#                                      #
########################################