########################################
#       #       S         #    #       #
#       #                 #    #       #
# K #   #                 #    #       #
#####   ######     ########    #       #
#            #            D            #
#            #     ########    ####    #
#   #   #    #     #      #    #       #
#   #   #    #     #      #    #       #
#   #   #    #            #    #       #
#   #   #    #            #    #   C   #
#####   #    ##############    #########
#   #   #                              #
#   #   #                              #
#@      #                              #
########################################