##############################
#@  #                        #
#                            #
#####                        #
#                            #
#                            #
#                            #
#                            #
#                            #
###############              #
#                            #
#                            #
#                            #
#C                           #
#                            #
#                            #
##############################